############
#..........#
#..#....#..#
#..........#
#..........#
#..#....#..#
#..........#
#..........#
#..#....#..#
#..........#
############