#######
#.....#
#..#..#
#.....#
#..#..#
#.....#
#######